10 10 10 10 0 0 10 10 10 10 10 
0 0 0 0 0 0 0 0 0 0 0 
0 2 3 4 0 0 0 0 0 0 0 
0 5 0 6 0 0 0 0 0 0 0
0 7 8 9 0 0 0 0 0 0 0 
0 0 0 0 0 0 0 0 0 0 0 
0 0 0 0 0 0 2 3 4 0 0 
0 0 0 0 0 0 5 0 6 0 0 
0 0 0 0 0 0 7 8 9 0 0
0 0 0 0 0 0 0 0 0 0 0 
0 2 3 4 0 0 0 0 0 0 0 
0 5 0 6 0 0 0 0 0 0 0 
0 7 8 9 0 0 0 0 0 0 0 
0 0 0 0 0 0 0 0 0 0 0 
10 10 10 10 0 0 10 10 10 10 10