1 1 1 1 1 1 1 1 1 1 1
1 2 3 4 1 1 1 2 3 4 1
1 5 1 6 1 1 1 5 1 6 1
1 7 8 9 1 1 1 7 8 9 1
1 1 1 1 1 1 1 1 1 1 1
1 1 1 1 1 1 1 1 1 1 1
1 1 1 1 1 1 1 1 1 1 1
1 1 1 1 1 1 1 1 1 1 1
1 1 1 1 1 1 1 1 1 1 1
1 1 1 1 1 1 1 1 1 1 1
1 1 1 1 1 1 1 1 1 1 1
1 2 3 4 1 1 1 2 3 4 1
1 5 1 6 1 1 1 5 1 6 1
1 7 8 9 1 1 1 7 8 9 1
1 1 1 1 1 1 1 1 1 1 1